der Bahnhof = station
die Bank = bank
das Bier = beer
die Botschaft = embassy
das Brot = bread
das Café = café
der Flughafen = airport
das Hotel = hotel
der Kaffee = coffee
die Milch = milk
das Restaurant = restaurant
die Streichhölzer = matches
der Tee = tea
das wasser = water
der wein = wine
die Zigarren = cigars
die Adresse = address
der Amerikaner = American
die Amerikanerin = American (lady)
der Beamte = official
die Dame = lady
die Deutsche = German (lady)
der Diplomat = diplomat
das Jahr = year
das Kino = movie theater
der Koffer = suitcase
das Konsulat = consulate
die Kontrolle = inspection
der Monat = month
die Nähe = vicinity, nearness
der Ober = waiter
die Ordnung = order
der Pass = passport
die Passkontrolle = passport inspection
die Reise = trip
die Stadt = city
der Zoll = customs office