Abend = evening
aber = but
acht = eight
auch = also, too
auch nicht =not ... either
auf deutsch = in German
Auf Wiedersehen = good-bye
der Bahnhof = station
die Bank = bank
das Bier =beer
bitte = please
bitte schön = here you are
die Botschaft = embassy
Bratwurst mit Sauerkraut = sausage and sauerkraut
das Brot = bread
das Café = café
da = there
danke = thanks
danke schön = many thanks
das = that
dort = there
drei = three
drüben = over there
eins = one
elf = eleven
er = he, it
es = it
essen = eat
etwas = some
der Flughafen = airport
Frau = Mrs.
fünf = five
geht = goes
geradeaus = straight ahead
gern(e) = with pleasure
gut = good, well
guten Abend = good evening
guten Morgen = good morning
guten Tag = hello (good day)
haben = have
Herr = Mr.
hier = here
das Hotel = hotel
ich = I
Ihnen = to you, with you
ist = is
ja = yes
der Kaffee = coffee
kosten = cost
kostet = costs
langsam = slow, slowly
links = left, to the left
man = one, you
Mark = Mark, Marks
mich = me (acc)
die Milch = milk
möchten = would like
möchten Sie = would you like
ich möchte = I would like
Morgen = morning
nein = no
neun = nine
nicht = not
nicht wahr? = Isn’t it (not true)?
nochmal = again
null = zero
Pfennig = penny, pennies
rechts = to the right
das Restaurant = restaurant
sagt = says
sagt man = does one say
sechs =six
sehr = very
sie = she, it
Sie = you
sieben = seven
sind = are(plural of der,die,das)
sprechen = speak
die Streichhölzer = matches
Tag = day
der Tee =tea
und = and
verstehen = understand
verstehen Sie = do you understand
ich verstehe = I understand
Verzeihung = excuse me
vier = four
was = what
das wasser = water
der wein = wine
wie = how
wie bitte? = I beg your pardon. What did you say?
wieviele = how many
wo = where
zehn = ten
die Zigarren = cigars
zwei = two
zwölf = twelve